250,75,150,350,425,200,300,150,200,300,350

75,200,200,200,200,300,300,425,425,425,425

0,1,0,0,1,0,0,0,0,0,0
1,0,1,0,0,0,0,0,0,0,0
0,1,0,2,0,0,0,1,0,0,0
0,0,2,0,1,0,0,0,0,0,1
1,0,0,1,0,0,0,0,0,0,0
0,0,0,0,0,0,1,0,1,0,0
0,0,0,0,0,1,0,0,0,1,0
0,0,1,0,0,0,0,0,1,0,0
0,0,0,0,0,1,0,1,0,0,0
0,0,0,0,0,0,1,0,0,0,1
0,0,0,1,0,0,0,0,0,1,0